geography_type,year,geography,total,age_0-17,age_18-29,age_30-39,age_40-49,age_50-59,age_60-69,age_70-79,age_80+,age_0-4,age_5-11,age_12-17,age_5+,age_18+,age_65+,female,male,latinx,asian_non-latinx,black_non-latinx,white_non-latinx,other_race_non-latinx
Citywide,2018,Chicago,2705988,548999,552935,456321,336457,312965,262991,155334,79986,168114,204152.0,175475.0,2537874,2156989,349712,1386113,1319875,776661,179841.0,784266.0,899980,119467.0
ZIP Code,2018,60601,14675,820,4606,2792,2190,1333,1340,1272,322,550,0.0,0.0,14125,13855,2075,7484,7191,1274,0.0,0.0,9677,0.0
ZIP Code,2018,60602,1244,149,435,462,135,53,10,0,0,61,0.0,0.0,1183,1095,5,551,693,81,0.0,0.0,788,0.0
ZIP Code,2018,60603,1174,56,561,101,97,197,97,65,0,13,0.0,0.0,1161,1118,112,601,573,115,0.0,0.0,707,0.0
ZIP Code,2018,60604,782,38,303,104,51,101,130,50,5,12,0.0,0.0,770,744,93,413,369,34,0.0,0.0,479,0.0
ZIP Code,2018,60605,27519,2260,8103,6316,3567,3344,2455,1204,270,837,0.0,0.0,26682,25259,2569,14381,13138,1608,0.0,0.0,15781,0.0
ZIP Code,2018,60606,3101,101,750,861,465,321,514,89,0,57,0.0,0.0,3044,3000,431,1599,1502,195,0.0,0.0,2129,0.0
ZIP Code,2018,60607,29591,3350,11384,7522,3048,1981,1321,632,353,1660,0.0,0.0,27931,26241,1604,14867,14724,2457,0.0,0.0,15440,0.0
ZIP Code,2018,60608,79205,14910,20255,14382,10013,8234,6440,3119,1852,4186,0.0,0.0,75019,64295,7852,35360,43845,40146,0.0,0.0,15148,0.0
ZIP Code,2018,60609,61495,16600,12450,8451,7324,7061,5176,3378,1055,4820,0.0,0.0,56675,44895,6977,31225,30270,32860,0.0,0.0,9172,0.0
ZIP Code,2018,60610,39019,3565,11398,8786,3667,3369,4242,2939,1053,1845,0.0,0.0,37174,35454,6029,21145,17874,2601,0.0,0.0,26809,0.0
ZIP Code,2018,60611,32426,1638,7544,7215,2478,3937,4785,3267,1562,892,0.0,0.0,31534,30788,7079,17219,15207,1701,0.0,0.0,23167,0.0
ZIP Code,2018,60612,34311,8160,7877,5806,4012,3889,2746,1209,612,2385,0.0,0.0,31926,26151,3136,17631,16680,4206,0.0,0.0,7334,0.0
ZIP Code,2018,60613,50113,5793,14643,12674,5748,4958,3187,1880,1230,2555,0.0,0.0,47558,44320,4429,24908,25205,5662,0.0,0.0,36600,0.0
ZIP Code,2018,60614,71308,9924,24906,14595,7345,5770,4930,2536,1302,3908,0.0,0.0,67400,61384,6179,35363,35945,4317,0.0,0.0,56762,0.0
ZIP Code,2018,60615,41563,6673,11046,6725,4549,4288,4323,2506,1453,2006,0.0,0.0,39557,34890,6022,22423,19140,2573,0.0,0.0,10984,0.0
ZIP Code,2018,60616,54464,8215,11692,9486,6755,6620,6221,3303,2172,2457,0.0,0.0,52007,46249,8683,28657,25807,4600,0.0,0.0,13160,0.0
ZIP Code,2018,60617,82534,21337,14040,8927,10660,10625,7611,5733,3601,5105,0.0,0.0,77429,61197,12791,44374,38160,31079,0.0,0.0,5215,0.0
ZIP Code,2018,60618,94395,20478,16967,19950,14365,10161,6948,3432,2094,6916,0.0,0.0,87479,73917,8526,46244,48151,38152,0.0,0.0,45553,0.0
ZIP Code,2018,60619,61258,13004,9237,7612,6708,9315,8378,3953,3051,3911,0.0,0.0,57347,48254,10410,33577,27681,869,0.0,0.0,854,0.0
ZIP Code,2018,60620,68096,14684,11375,7287,8437,10136,7482,5062,3633,3563,0.0,0.0,64533,53412,11842,38095,30001,911,0.0,0.0,755,0.0
ZIP Code,2018,60621,29042,7810,5183,3250,2926,4073,2897,1739,1164,2504,0.0,0.0,26538,21232,3928,15858,13184,1061,0.0,0.0,320,0.0
ZIP Code,2018,60622,52793,8055,14666,15452,6263,3783,2594,1125,855,3540,0.0,0.0,49253,44738,3119,25577,27216,11579,0.0,0.0,34144,0.0
ZIP Code,2018,60623,85979,26387,15945,12798,10170,9008,6621,3450,1600,6801,0.0,0.0,79178,59592,7805,44032,41947,56864,0.0,0.0,2508,0.0
ZIP Code,2018,60624,36158,11024,6743,4302,4411,4232,2806,1616,1024,3276,0.0,0.0,32882,25134,3922,19252,16906,1915,0.0,0.0,989,0.0
ZIP Code,2018,60625,79243,15820,15783,16649,11120,8508,6399,2813,2151,5981,0.0,0.0,73262,63423,7575,39551,39692,25978,0.0,0.0,36086,0.0
ZIP Code,2018,60626,49730,8302,12049,9619,6518,5764,4040,2143,1295,2553,0.0,0.0,47177,41428,5031,25148,24582,10252,0.0,0.0,22444,0.0
ZIP Code,2018,60628,66724,15513,11827,7029,8502,8953,7216,4984,2700,4153,0.0,0.0,62571,51211,11272,35908,30816,2292,0.0,0.0,1281,0.0
ZIP Code,2018,60629,111850,32380,21377,16517,14408,11184,8590,5356,2038,8884,0.0,0.0,102966,79470,11127,57035,54815,79432,0.0,0.0,9203,0.0
ZIP Code,2018,60630,57344,11913,7773,8847,7381,8978,6351,3422,2679,3527,0.0,0.0,53817,45431,8738,29455,27889,16007,0.0,0.0,32184,0.0
ZIP Code,2018,60631,29529,5985,3662,3896,4358,4127,3549,1897,2055,1875,0.0,0.0,27654,23544,5469,15265,14264,3152,0.0,0.0,24253,0.0
ZIP Code,2018,60632,91039,26881,17407,13371,11676,9069,6795,4009,1831,7048,0.0,0.0,83991,64158,8702,44667,46372,76434,0.0,0.0,7996,0.0
ZIP Code,2018,60633,12871,2827,2173,1766,1515,2173,1227,765,425,890,0.0,0.0,11981,10044,1676,6085,6786,5790,0.0,0.0,4048,0.0
ZIP Code,2018,60634,75995,16581,11044,11242,10440,10766,8425,4638,2859,5026,0.0,0.0,70969,59414,11417,39061,36934,29065,0.0,0.0,41060,0.0
ZIP Code,2018,60636,32203,7442,5062,3611,3903,4461,3132,3321,1271,1964,0.0,0.0,30239,24761,6194,16978,15225,2472,0.0,0.0,338,0.0
ZIP Code,2018,60637,47454,11552,11606,5984,4834,5367,4549,2253,1309,3182,0.0,0.0,44272,35902,5463,26577,20877,1341,0.0,0.0,6858,0.0
ZIP Code,2018,60638,58797,14300,8208,9003,7394,8132,6179,3337,2244,4023,0.0,0.0,54774,44497,8239,29764,29033,30440,0.0,0.0,25612,0.0
ZIP Code,2018,60639,90517,24573,16203,13873,12852,10387,7660,3539,1430,6633,0.0,0.0,83884,65944,8137,45508,45009,70538,0.0,0.0,6104,0.0
ZIP Code,2018,60640,69715,9545,14152,14142,10576,8963,5970,3574,2793,3256,0.0,0.0,66459,60170,8987,34101,35614,9939,0.0,0.0,38554,0.0
ZIP Code,2018,60641,71023,15849,11820,12054,9928,9061,7206,3177,1928,4627,0.0,0.0,66396,55174,7905,36182,34841,38350,0.0,0.0,26008,0.0
ZIP Code,2018,60642,20201,2331,6707,5581,2200,1416,1110,585,271,999,0.0,0.0,19202,17870,1322,10092,10109,4074,0.0,0.0,12126,0.0
ZIP Code,2018,60643,49870,11082,6126,5627,6451,8105,5905,3706,2868,3134,0.0,0.0,46736,38788,9153,27232,22638,1649,0.0,0.0,10138,0.0
ZIP Code,2018,60644,47712,12336,9394,5857,5261,6048,4851,2517,1448,3623,0.0,0.0,44089,35376,6201,25669,22043,3068,0.0,0.0,1392,0.0
ZIP Code,2018,60645,47732,12906,7091,6952,5824,5468,5064,2621,1806,4329,0.0,0.0,43403,34826,6564,23992,23740,8127,0.0,0.0,21481,0.0
ZIP Code,2018,60646,27987,6000,3377,3458,3787,4086,3238,2108,1933,1802,0.0,0.0,26185,21987,5732,14765,13222,3971,0.0,0.0,20315,0.0
ZIP Code,2018,60647,87509,16298,22356,20993,11055,7700,5309,2695,1103,5924,0.0,0.0,81585,71211,6224,43182,44327,39226,0.0,0.0,38809,0.0
ZIP Code,2018,60649,46024,10493,7505,6417,5950,5706,5593,2807,1553,3215,0.0,0.0,42809,35531,6570,26852,19172,1183,0.0,0.0,1315,0.0
ZIP Code,2018,60651,63218,17329,11457,8910,7649,7391,5787,3359,1336,4780,0.0,0.0,58438,45889,7220,34084,29134,26860,0.0,0.0,2623,0.0
ZIP Code,2018,60652,43907,11679,7185,5764,6105,6065,4062,1897,1150,2769,0.0,0.0,41138,32228,4740,23123,20784,17479,0.0,0.0,4472,0.0
ZIP Code,2018,60653,31972,8912,4760,4635,4404,3369,3233,1547,1112,2632,0.0,0.0,29340,23060,4122,18269,13703,689,0.0,0.0,1374,0.0
ZIP Code,2018,60654,19135,1611,5273,5645,2508,2217,1231,489,161,1164,0.0,0.0,17971,17524,1127,9381,9754,997,0.0,0.0,14124,0.0
ZIP Code,2018,60655,28804,7015,4153,3686,3798,4366,3278,1582,926,2026,0.0,0.0,26778,21789,3731,14928,13876,2390,0.0,0.0,23795,0.0
ZIP Code,2018,60656,27579,4947,3690,4934,3623,3805,3208,2115,1257,1697,0.0,0.0,25882,22632,4637,13587,13992,3382,0.0,0.0,21053,0.0
ZIP Code,2018,60657,70052,8438,23899,17032,7053,5646,4288,2099,1597,3808,0.0,0.0,66244,61614,5618,34638,35414,4901,0.0,0.0,56392,0.0
ZIP Code,2018,60659,41068,10154,7449,6165,5198,5372,3730,2043,957,2847,0.0,0.0,38221,30914,4603,20037,21031,7880,0.0,0.0,16363,0.0
ZIP Code,2018,60660,43242,5045,10237,8402,5742,5475,4709,2347,1285,1891,0.0,0.0,41351,38197,5741,21705,21537,7728,0.0,0.0,22313,0.0
ZIP Code,2018,60661,9926,683,3772,3229,1227,623,369,23,0,447,0.0,0.0,9479,9243,217,4817,5109,640,0.0,0.0,5091,0.0
ZIP Code,2018,60666,0,0,0,0,0,0,0,0,0,0,0.0,0.0,0,0,0,0,0,0,0.0,0.0,0,0.0
ZIP Code,2018,60707,43019,9285,6546,5958,5818,6006,5111,2582,1713,2292,0.0,0.0,40727,33734,6745,22267,20752,16505,0.0,0.0,20677,0.0
ZIP Code,2018,60827,28577,8345,4822,3415,3957,3569,2879,1196,394,2591,0.0,0.0,25986,20232,2763,15666,12911,1222,0.0,0.0,760,0.0
Citywide,2019,Chicago,2693959,555424,526788,469300,340219,294864,261009,157790,88565,162797,210448.0,180859.0,2531162,2138535,362629,1382528,1311431,776290,184768.0,768524.0,901941,62436.0
Zip Code,2019,60601,15083,880,5207,2796,2090,970,1733,1154,253,426,237.0,199.0,14657,14203,2109,8054,7029,1224,2859.0,638.0,9939,423.0
Zip Code,2019,60602,1145,149,207,527,180,66,16,0,0,56,91.0,0.0,1089,996,6,506,639,74,245.0,49.0,680,97.0
Zip Code,2019,60603,1052,16,498,131,76,174,85,72,0,5,0.0,11.0,1047,1036,120,529,523,34,337.0,34.0,640,7.0
Zip Code,2019,60604,823,36,325,159,55,91,103,45,9,10,7.0,19.0,813,787,72,431,392,28,240.0,41.0,514,0.0
Zip Code,2019,60605,29060,2411,8519,7270,3621,3180,2165,1445,449,1047,966.0,390.0,28013,26649,2923,15928,13132,2185,4377.0,4270.0,16865,1363.0
Zip Code,2019,60606,3287,119,660,1096,483,342,479,108,0,75,44.0,0.0,3212,3168,378,1606,1681,188,667.0,58.0,2206,168.0
Zip Code,2019,60607,29293,3141,11280,7216,3107,2154,1403,651,341,1317,1257.0,542.0,27976,26152,1544,14563,14730,2151,6304.0,4168.0,15719,951.0
Zip Code,2019,60608,80059,14812,20455,14507,10292,8176,6705,3266,1846,4318,6021.0,4449.0,75741,65247,7939,35599,44460,38984,9914.0,13326.0,16955,880.0
Zip Code,2019,60609,60939,15773,12444,8167,7597,6735,5442,3723,1058,4648,6112.0,4998.0,56291,45166,7373,30782,30157,32291,3792.0,15015.0,9232,609.0
Zip Code,2019,60610,40548,3716,11990,9127,3566,3454,4325,3148,1222,1670,997.0,1041.0,38878,36832,6537,21529,19019,2526,3532.0,5880.0,27468,1142.0
Zip Code,2019,60611,33224,1856,7778,7168,2693,4066,4806,3344,1513,965,445.0,446.0,32259,31368,7142,17716,15508,1573,6156.0,967.0,23769,759.0
Zip Code,2019,60612,33735,7837,7330,5921,4020,3695,2842,1363,727,2255,2832.0,2431.0,31480,25898,3325,17781,15954,4056,1449.0,19873.0,7629,728.0
Zip Code,2019,60613,50761,5885,14036,13315,5534,5059,3409,2080,1443,2726,1981.0,1178.0,48035,44876,4904,25108,25653,5645,3491.0,2985.0,37074,1566.0
Zip Code,2019,60614,71954,10115,24583,14628,7458,5728,5230,2735,1477,3738,3678.0,2638.0,68216,61839,6729,35273,36681,4438,5218.0,3016.0,57117,2165.0
Zip Code,2019,60615,40590,6219,10400,6495,4407,4266,4536,2621,1646,2054,2323.0,1842.0,38536,34371,6411,22464,18126,2220,3448.0,21960.0,11148,1814.0
Zip Code,2019,60616,54197,7829,11557,8634,7107,7319,6256,3243,2252,2095,2782.0,2923.0,52102,46368,8636,28388,25809,4569,21379.0,12694.0,14418,1137.0
Zip Code,2019,60617,83553,22163,14558,8990,10282,10804,7459,5638,3659,5372,8092.0,8699.0,78181,61390,12578,45646,37907,31048,220.0,46967.0,4934,384.0
Zip Code,2019,60618,94907,20662,16885,20317,14662,9723,6847,3814,1997,6642,8411.0,5570.0,88265,74245,8699,47171,47736,38208,5757.0,2408.0,45593,2941.0
Zip Code,2019,60619,61207,12737,9612,7647,6791,9186,8006,4051,3177,3861,4870.0,4002.0,57346,48470,10458,33573,27634,804,145.0,58412.0,903,943.0
Zip Code,2019,60620,67711,15359,10807,7456,8139,9801,7622,5110,3417,3914,5860.0,5585.0,63797,52352,11975,37282,30429,1246,276.0,64588.0,847,754.0
Zip Code,2019,60621,28018,7506,4822,3148,2806,3819,3002,1793,1122,2387,2964.0,2151.0,25631,20512,3969,14898,13120,891,68.0,26517.0,289,253.0
Zip Code,2019,60622,53294,7684,14300,15850,6692,3993,2626,1236,913,3536,2437.0,1708.0,49758,45610,3275,25366,27928,12207,2335.0,3150.0,34207,1395.0
Zip Code,2019,60623,81283,23403,15040,12147,9672,8570,6534,4516,1401,6073,9735.0,7595.0,75210,57880,8645,41033,40250,54297,80.0,24101.0,2366,439.0
Zip Code,2019,60624,34892,10189,6449,4158,4122,3967,3369,1585,1053,2839,4268.0,3074.0,32053,24703,4038,18344,16548,1773,53.0,31436.0,1109,521.0
Zip Code,2019,60625,79444,15998,14847,17078,11236,8505,6608,3005,2167,5762,5896.0,4285.0,73682,63446,8057,40178,39266,25483,10658.0,3599.0,36289,3415.0
Zip Code,2019,60626,50544,8949,12083,9436,6774,5958,3966,1959,1419,2851,3615.0,2397.0,47693,41595,4957,25646,24898,9906,2712.0,13410.0,22592,1924.0
Zip Code,2019,60628,64254,14482,11307,7139,7957,8359,7303,4771,2936,3945,5447.0,5085.0,60309,49772,11046,34294,29960,2267,135.0,59478.0,1333,1041.0
Zip Code,2019,60629,110029,31655,21216,15007,14724,11187,8119,6041,2080,8901,11658.0,11095.0,101128,78374,11593,56206,53823,78826,582.0,21116.0,8463,1042.0
Zip Code,2019,60630,56433,11266,7717,8800,7969,8263,6654,3340,2424,3111,4526.0,3621.0,53322,45167,8687,28985,27448,16066,6177.0,831.0,31403,1956.0
Zip Code,2019,60631,29529,5864,3630,4016,3914,4447,3717,1794,2147,2066,2248.0,1550.0,27463,23665,5573,15197,14332,3500,1031.0,269.0,23763,966.0
Zip Code,2019,60632,89857,25874,17624,12751,11240,9063,6797,4774,1734,6734,10103.0,9037.0,83123,63983,9384,43856,46001,74575,6176.0,1034.0,7652,420.0
Zip Code,2019,60633,12689,2781,1909,1787,1480,1943,1286,975,528,710,805.0,1257.0,11979,9908,2089,6044,6645,6038,0.0,2955.0,3654,42.0
Zip Code,2019,60634,75082,16271,10415,11160,10302,10919,8529,4761,2725,4508,6182.0,5573.0,70574,58811,11445,38764,36318,28812,4121.0,1073.0,40322,754.0
Zip Code,2019,60636,30024,6693,4672,3304,3432,3969,3019,3746,1189,1859,2461.0,2373.0,28165,23331,6321,16097,13927,2823,24.0,26359.0,441,377.0
Zip Code,2019,60637,47300,11114,11975,5877,4931,5254,4636,2183,1330,3022,4169.0,3813.0,44278,36186,5588,26629,20671,1543,2218.0,35425.0,6966,1148.0
Zip Code,2019,60638,58669,14545,7924,8989,7264,7874,6506,3398,2169,3884,5542.0,5119.0,54785,44124,8240,29443,29226,29543,311.0,2177.0,26016,622.0
Zip Code,2019,60639,88204,23036,15550,13440,12571,10179,8034,3780,1614,6161,9273.0,7600.0,82043,65168,8698,44143,44061,68792,1124.0,10828.0,6628,832.0
Zip Code,2019,60640,69363,9048,14021,15071,10179,8372,6017,3545,3110,2910,3768.0,2323.0,66453,60315,9319,33290,36073,9772,7411.0,11484.0,38787,1909.0
Zip Code,2019,60641,69880,15420,10959,11809,10150,8899,7444,3286,1913,4385,5936.0,5075.0,65495,54460,8121,35575,34305,38120,3208.0,1429.0,25014,2109.0
Zip Code,2019,60642,19716,1839,6660,5777,2209,1378,1149,484,220,916,581.0,342.0,18800,17877,1175,9427,10289,3202,1427.0,1962.0,12534,591.0
Zip Code,2019,60643,48887,10830,5760,5903,5640,7757,6766,3341,2890,2989,3560.0,4254.0,45898,38057,9169,26875,22012,1509,139.0,35352.0,10446,1441.0
Zip Code,2019,60644,46591,12104,8152,5982,5530,5631,5072,2507,1613,3337,4801.0,3963.0,43254,34487,6470,24672,21919,3194,103.0,41158.0,1781,355.0
Zip Code,2019,60645,47270,12801,7047,6555,6026,5847,4682,2478,1834,4422,4648.0,3717.0,42848,34469,6345,23525,23745,8312,8373.0,7200.0,21103,2282.0
Zip Code,2019,60646,28569,6507,3187,3464,3915,3779,3546,2231,1940,1801,2422.0,2284.0,26768,22062,5914,15310,13259,4300,2771.0,286.0,20625,587.0
Zip Code,2019,60647,87633,15892,22226,21408,11447,7438,5301,2800,1121,5848,5377.0,4637.0,81785,71741,6315,43228,44405,37622,3019.0,4268.0,40544,2180.0
Zip Code,2019,60649,46633,10399,7662,7040,6036,5582,5548,2849,1517,3122,3913.0,3359.0,43511,36234,6723,26590,20043,1189,148.0,43366.0,1234,696.0
Zip Code,2019,60651,63492,17077,11299,9175,8027,7257,5959,3196,1502,4563,6594.0,5906.0,58929,46415,7500,34216,29276,27245,295.0,32223.0,2799,930.0
Zip Code,2019,60652,43447,11360,7017,5397,6166,6133,4153,2034,1187,2695,4731.0,3933.0,40752,32087,5061,23006,20441,18027,429.0,19747.0,4183,1061.0
Zip Code,2019,60653,33154,9162,5169,4760,4211,3680,3352,1842,978,2902,3319.0,2923.0,30252,23992,4239,18812,14342,913,418.0,29379.0,1624,820.0
Zip Code,2019,60654,20022,1463,5555,5971,2723,2090,1477,539,204,973,404.0,86.0,19049,18559,1330,9979,10043,1156,2851.0,1070.0,14365,580.0
Zip Code,2019,60655,28569,7025,4090,3459,3862,4305,3293,1583,952,1922,2689.0,2414.0,26647,21544,3648,14627,13942,2586,436.0,1836.0,23377,334.0
Zip Code,2019,60656,28218,5241,3628,5206,3587,3756,3230,2244,1326,1878,1902.0,1461.0,26340,22977,4968,13796,14422,3768,2372.0,327.0,21089,662.0
Zip Code,2019,60657,70958,8951,23709,17072,7136,5847,4529,2158,1556,3875,3048.0,2028.0,67083,62007,5702,35306,35652,5385,4887.0,2085.0,56603,1998.0
Zip Code,2019,60659,42735,11218,6875,6767,5499,5173,3984,2231,988,3272,4435.0,3503.0,39463,31517,5103,21244,21491,8873,11861.0,3453.0,16070,2478.0
Zip Code,2019,60660,44498,5361,10768,8716,5623,5616,4552,2422,1440,2009,2166.0,1138.0,42489,39137,5942,22027,22471,7614,6000.0,5937.0,23247,1700.0
Zip Code,2019,60661,10354,917,3386,3459,1430,658,409,58,37,492,292.0,133.0,9862,9437,332,5173,5181,641,2950.0,429.0,6027,307.0
ZIP Code,2019,60666,0,0,0,0,0,0,0,0,0,0,0.0,0.0,0,0,0,0,0,0,0.0,0.0,0,0.0
Zip Code,2019,60707,43093,8982,6752,5495,6005,6181,5269,2826,1583,2331,3726.0,2925.0,40762,34111,6979,22556,20537,16862,1533.0,2981.0,20783,934.0
Zip Code,2019,60827,28483,8229,5017,3329,4095,3389,2758,1177,489,2578,3115.0,2530.0,25905,20254,2859,16017,12466,1486,39.0,25575.0,848,535.0
Citywide,2020,Chicago,2699347,552668,548747,463143,336591,313865,255435,145426,83472,165844,207791.0,177949.0,2533503,2146679,342174,1388469,1310878,772791,182251.0,776470.0,900055,67780.0
Zip Code,2020,60601,14513,825,4696,3048,1815,809,1974,1070,276,275,410.0,120.0,14238,13688,2605,7894,6619,1242,3528.0,679.0,8614,450.0
Zip Code,2020,60602,1596,115,332,860,191,81,17,0,0,49,66.0,0.0,1547,1481,4,744,852,120,435.0,37.0,794,210.0
Zip Code,2020,60603,1186,15,423,248,68,176,146,91,19,3,3.0,9.0,1183,1171,198,560,626,62,397.0,29.0,692,6.0
Zip Code,2020,60604,729,5,313,171,30,77,89,36,8,0,0.0,5.0,729,724,65,441,288,23,127.0,72.0,507,0.0
Zip Code,2020,60605,30950,2608,8678,8486,3408,3377,2282,1702,409,1359,964.0,276.0,29591,28342,3154,16330,14620,2232,5648.0,4272.0,17704,1094.0
Zip Code,2020,60606,3204,96,709,1169,475,373,264,118,0,63,33.0,0.0,3141,3108,301,1679,1525,152,1037.0,50.0,1835,130.0
Zip Code,2020,60607,30306,3362,11381,7946,3004,2194,1315,561,543,1679,1100.0,551.0,28627,26944,1609,14910,15396,2768,6415.0,3878.0,16068,1177.0
Zip Code,2020,60608,80011,14068,20182,15269,10053,8276,7137,3407,1619,3964,5777.0,4308.0,76047,65943,8420,35434,44577,37287,11310.0,13763.0,16527,1124.0
Zip Code,2020,60609,60551,15379,11640,8023,8382,6892,5364,3810,1061,4004,6189.0,5172.0,56547,45172,7675,30569,29982,31898,4332.0,14380.0,9321,620.0
Zip Code,2020,60610,40954,3385,12949,8874,3303,3753,4522,2975,1193,1292,1049.0,1036.0,39662,37569,6136,21419,19535,2316,4169.0,5120.0,27733,1616.0
Zip Code,2020,60611,33937,2127,8405,6959,3061,4126,4435,3468,1356,1000,641.0,486.0,32937,31810,7036,18054,15883,1946,7015.0,957.0,23261,758.0
Zip Code,2020,60612,32240,6760,6933,5287,4255,3855,3051,1393,706,1793,2594.0,2042.0,30447,25480,3448,17225,15015,4749,1518.0,17357.0,7634,982.0
Zip Code,2020,60613,51399,6285,14297,13342,5915,4930,3289,2065,1276,2879,2157.0,1249.0,48520,45114,4670,26339,25060,6166,3413.0,3170.0,36979,1671.0
Zip Code,2020,60614,72391,10603,24659,14106,7173,6262,5552,2726,1310,3479,4043.0,3031.0,68912,61788,6427,36172,36219,4456,5249.0,2678.0,57985,2023.0
Zip Code,2020,60615,41198,6110,11393,6135,4195,4609,4863,2440,1453,2016,2176.0,1918.0,39182,35088,6131,22639,18559,2258,3373.0,21733.0,11747,2087.0
Zip Code,2020,60616,52557,7134,11280,8908,6237,7390,6164,2968,2476,2258,2360.0,2487.0,50299,45423,8787,27430,25127,4029,20303.0,12577.0,14378,1270.0
Zip Code,2020,60617,82101,20843,13979,9578,10027,10431,8133,5569,3541,4898,7579.0,8366.0,77203,61258,13343,45093,37008,31311,194.0,45210.0,4830,556.0
Zip Code,2020,60618,94646,20813,16088,20651,14846,9977,6466,4014,1791,7002,7973.0,5785.0,87644,73833,8360,47492,47154,37188,6237.0,2208.0,45370,3643.0
Zip Code,2020,60619,61372,12667,9118,7547,6800,9223,8048,4472,3497,3457,4505.0,4702.0,57915,48705,11362,34416,26956,1050,173.0,58359.0,613,1177.0
Zip Code,2020,60620,68761,16203,10753,7954,8243,9215,7759,5081,3553,4177,6390.0,5636.0,64584,52558,12360,37732,31029,1680,233.0,65198.0,797,853.0
Zip Code,2020,60621,26736,7157,4311,2784,2662,3654,3236,1580,1352,2442,2644.0,2064.0,24294,19579,4145,14588,12148,908,131.0,24744.0,389,564.0
Zip Code,2020,60622,52957,7103,14013,16274,6717,3990,2471,1373,1016,3220,2199.0,1670.0,49737,45854,3572,26139,26818,11265,2401.0,2833.0,34127,2331.0
Zip Code,2020,60623,77732,20657,14285,11701,9476,8424,6855,4615,1719,5313,8361.0,6983.0,72419,57075,9465,39368,38364,51970,213.0,22214.0,2989,346.0
Zip Code,2020,60624,35054,9336,6757,4366,4094,4253,3516,1640,1092,2729,3849.0,2748.0,32325,25718,4204,18277,16777,2589,48.0,30583.0,1176,658.0
Zip Code,2020,60625,78820,15832,14588,17768,10967,8363,6687,2691,1924,5366,5826.0,4584.0,73454,62988,7303,40253,38567,25957,9250.0,3504.0,36492,3617.0
Zip Code,2020,60632,86715,23661,17253,12227,10482,9650,6839,4795,1808,6266,9150.0,8244.0,80449,63054,9356,41922,44793,71914,5774.0,936.0,7721,370.0
Zip Code,2020,60633,12720,2785,1929,1958,1374,2099,1156,927,492,639,1100.0,1036.0,12081,9935,1945,6373,6347,5605,0.0,3268.0,3817,30.0
Zip Code,2020,60634,75604,15430,10876,10909,10921,11400,7989,5382,2697,3927,5624.0,5871.0,71677,60174,11221,38951,36653,29667,3881.0,1441.0,39825,790.0
Zip Code,2020,60636,30039,6809,4911,3142,3505,3903,2919,3563,1287,1786,2584.0,2439.0,28253,23230,6067,16370,13669,3428,24.0,25679.0,395,513.0
Zip Code,2020,60637,46621,10666,11532,5997,4924,4970,4668,2521,1343,2717,4130.0,3707.0,43904,35955,5751,26192,20429,1409,2279.0,34827.0,6451,1655.0
Zip Code,2020,60638,57057,13803,7720,8573,7682,8140,6209,2799,2131,3519,5290.0,4994.0,53538,43254,7700,27984,29073,30149,310.0,1959.0,24154,485.0
Zip Code,2020,60639,88515,23270,15119,13086,12292,9829,8491,4421,2007,5868,8876.0,8523.0,82647,65245,10149,44344,44171,67494,1232.0,11718.0,7144,927.0
Zip Code,2020,60640,69726,9088,14076,15316,9444,9428,6077,3264,3033,3227,3498.0,2348.0,66499,60638,8860,33739,35987,9836,7808.0,11682.0,38178,2222.0
Zip Code,2020,60641,70163,15784,11010,11930,10276,8953,6964,3477,1769,4413,6052.0,5291.0,65750,54379,7836,36602,33561,37411,3462.0,1777.0,25057,2456.0
Zip Code,2020,60642,20191,1810,6738,5997,2572,1371,1089,418,196,913,521.0,376.0,19278,18381,1074,9968,10223,3450,1708.0,1916.0,12346,771.0
Zip Code,2020,60643,48572,11319,6078,5563,5646,7595,6204,3208,2959,2949,3877.0,4472.0,45623,37253,8783,26643,21929,1818,207.0,34282.0,10549,1716.0
Zip Code,2020,60644,45919,11798,7417,5721,5613,5164,5681,2759,1766,3627,4513.0,3656.0,42292,34121,6983,24201,21718,4286,148.0,38773.0,1840,872.0
Zip Code,2020,60645,46924,12164,7302,5971,6731,5465,5086,2485,1720,4059,4407.0,3685.0,42865,34760,6366,23331,23593,9083,7214.0,6711.0,21736,2180.0
Zip Code,2020,60646,29043,6708,3478,3564,4361,3692,3484,2045,1711,1898,2727.0,2083.0,27145,22335,5322,15601,13442,4086,2803.0,179.0,21289,686.0
Zip Code,2020,60647,85658,15040,21614,21752,10871,7195,5272,2445,1469,5618,5127.0,4267.0,80040,70618,6254,43046,42612,34024,3394.0,4039.0,41547,2654.0
Zip Code,2020,60649,47084,10038,7796,7125,5897,5588,5941,3113,1586,3362,3578.0,3097.0,43722,37046,7304,26070,21014,1261,164.0,43514.0,1487,658.0
Zip Code,2020,60651,63679,16789,11532,9323,7695,7482,5852,3147,1859,3808,6802.0,6170.0,59871,46890,7801,34149,29530,25440,181.0,33762.0,3183,1113.0
Zip Code,2020,60652,42296,10768,6875,5147,5950,5941,4444,2077,1094,2596,3904.0,4267.0,39700,31528,5100,21753,20543,18354,356.0,18670.0,4342,574.0
Zip Code,2020,60653,33574,8697,5366,4804,3855,3872,3528,2120,1332,2876,3312.0,2490.0,30698,24877,4978,19060,14514,1382,468.0,28717.0,2097,910.0
Zip Code,2020,60654,20812,1228,6074,6593,2215,2398,1481,540,283,794,391.0,43.0,20018,19584,1460,9951,10861,1598,2637.0,775.0,14977,825.0
Zip Code,2020,60655,27771,6878,3741,3312,3624,4216,3540,1595,865,1793,2597.0,2488.0,25978,20893,3847,14296,13475,2537,376.0,1587.0,22424,847.0
Zip Code,2020,60656,28982,5445,3827,5520,3516,3713,3646,2147,1168,1969,2102.0,1374.0,27013,23537,5233,14086,14896,3587,2796.0,950.0,20907,742.0
Zip Code,2020,60657,70489,8776,24075,16688,6733,5762,4573,2424,1458,3696,3252.0,1828.0,66793,61713,5949,33780,36709,5782,4898.0,2326.0,54926,2557.0
Zip Code,2020,60659,43843,11916,6839,6603,5566,5244,4704,1947,1024,3668,4272.0,3967.0,40175,31927,4945,21932,21911,9085,11517.0,3594.0,16904,2743.0
Zip Code,2020,60660,45131,5779,11358,8952,5574,5192,4463,2451,1362,2279,2141.0,1302.0,42852,39352,5842,22140,22991,7995,6455.0,6621.0,22350,1710.0
Zip Code,2020,60661,10734,884,3350,3953,1442,658,317,73,57,592,250.0,42.0,10142,9850,298,5240,5494,894,2977.0,307.0,6209,347.0
ZIP Code,2020,60666,0,0,0,0,0,0,0,0,0,0,0.0,0.0,0,0,0,0,0,0,0.0,0.0,0,0.0
Zip Code,2020,60707,42434,8937,6383,5901,6070,6218,4672,2687,1566,2145,3731.0,3061.0,40289,33497,6507,22350,20084,17614,1404.0,2812.0,19880,724.0
Zip Code,2020,60827,28327,8579,4770,3536,3472,3357,2952,1178,483,2699,3187.0,2686.0,25628,19748,3023,15709,12618,1861,2.0,25362.0,646,456.0
Citywide,2021,Chicago,2696561,540255,519276,464574,338452,314035,269647,167261,83061,149430,215061.0,174812.0,2547131,2156306,373166,1387010,1309551,777744,184263.0,757971.0,887130,89453.0
Zip Code,2021,60601,14804,999,5065,3739,1390,970,1515,910,216,359,436.0,184.0,14445,13805,1963,8260,6544,1234,3827.0,908.0,8124,711.0
Zip Code,2021,60602,1142,119,163,658,67,95,33,7,0,60,59.0,0.0,1082,1023,24,540,602,311,101.0,38.0,537,155.0
Zip Code,2021,60603,1275,33,399,266,81,196,191,93,16,12,11.0,10.0,1263,1242,224,595,680,78,397.0,71.0,723,6.0
Zip Code,2021,60604,687,6,335,122,38,74,61,33,18,0,0.0,6.0,687,681,71,421,266,30,70.0,72.0,515,0.0
Zip Code,2021,60605,32077,2841,9038,8714,3740,3127,2539,1640,438,1196,1174.0,461.0,30881,29236,3143,16395,15682,2841,4942.0,4571.0,18296,1427.0
Zip Code,2021,60606,3298,121,790,1202,367,478,184,156,0,75,46.0,0.0,3223,3177,256,1567,1731,179,1087.0,16.0,1967,49.0
Zip Code,2021,60607,29990,3300,11585,7356,3360,1967,1289,624,509,1622,1127.0,515.0,28368,26690,1594,14801,15189,2743,6690.0,3717.0,15534,1306.0
Zip Code,2021,60608,83689,15392,19489,16442,10590,9000,7655,3393,1728,3924,6462.0,4994.0,79765,68297,8837,36923,46766,39476,11486.0,14042.0,16943,1742.0
Zip Code,2021,60609,61861,15202,11900,8011,8603,7565,5743,3821,1016,3888,6090.0,5212.0,57973,46659,7772,30963,30898,33408,3924.0,14573.0,9140,816.0
Zip Code,2021,60610,42422,3817,13841,8534,3536,4139,4285,2945,1325,1287,1292.0,1231.0,41135,38605,6390,22094,20328,2109,4019.0,4967.0,29571,1756.0
Zip Code,2021,60611,34562,2093,8272,6821,3200,4446,4710,3601,1419,1117,590.0,386.0,33445,32469,7339,18203,16359,2232,7076.0,1077.0,23254,923.0
Zip Code,2021,60612,33908,7522,6902,6022,4567,3769,3091,1459,576,1967,2924.0,2368.0,31941,26386,3386,17922,15986,5119,1535.0,18516.0,7703,1035.0
Zip Code,2021,60613,53282,6579,14724,13666,5978,5383,3432,2264,1256,2936,2315.0,1328.0,50346,46703,4757,26335,26947,6124,4572.0,3140.0,37714,1732.0
Zip Code,2021,60614,72119,10625,23433,14255,7267,6302,5659,3127,1451,3396,4108.0,3078.0,68723,61494,7001,35674,36445,4411,5148.0,2734.0,57602,2224.0
Zip Code,2021,60615,41767,6101,11172,6657,4594,4703,4983,2358,1199,1759,2232.0,2103.0,40008,35666,5885,22768,18999,2205,3395.0,22218.0,11805,2144.0
Zip Code,2021,60616,53085,7072,10961,9848,5886,7332,6280,3176,2530,2257,2503.0,2285.0,50828,46013,8695,27548,25537,3988,19773.0,12330.0,15582,1412.0
Zip Code,2021,60617,84193,21647,13650,10388,10017,10635,8727,5763,3366,5041,7980.0,8626.0,79152,62546,13507,46014,38179,33740,171.0,44794.0,4880,608.0
Zip Code,2021,60618,95078,20763,15721,20655,15333,10280,6732,3849,1745,6673,7628.0,6390.0,88405,74315,8176,47846,47232,36407,6077.0,2417.0,45911,4266.0
Zip Code,2021,60619,63481,13711,8621,8675,7304,9386,8234,4333,3217,3597,5124.0,4987.0,59884,49770,11094,35506,27975,1043,168.0,60173.0,607,1490.0
Zip Code,2021,60620,69357,16375,11103,7892,8218,9119,7917,5087,3646,4566,6255.0,5554.0,64791,52982,12580,38240,31117,1937,204.0,65454.0,774,988.0
Zip Code,2021,60621,26538,7066,4325,2919,2744,3611,3047,1585,1241,2069,2730.0,2257.0,24469,19472,4039,13937,12601,959,144.0,24499.0,398,538.0
Zip Code,2021,60622,54650,7711,14330,17062,6684,3977,2478,1426,982,3549,2446.0,1701.0,51101,46939,3568,27177,27473,11270,2605.0,3189.0,35064,2522.0
Zip Code,2021,60623,77352,20412,14022,11283,9656,8521,6635,4999,1824,5125,8375.0,6912.0,72227,56940,9860,39857,37495,51574,263.0,21992.0,3002,521.0
Zip Code,2021,60624,36986,9901,7066,4505,4707,4350,3824,1591,1042,2668,3727.0,3498.0,34318,27085,4110,19078,17908,2859,137.0,32122.0,1262,606.0
Zip Code,2021,60625,80028,15667,14404,17535,11247,9346,6949,3029,1851,4751,5979.0,4797.0,75277,64361,8047,40506,39522,25898,10121.0,3780.0,37163,3066.0
Zip Code,2021,60632,87395,23015,17076,12882,10088,10607,6700,5277,1750,6159,8628.0,8227.0,81236,64380,9802,42553,44842,72204,6020.0,881.0,7916,374.0
Zip Code,2021,60633,12674,2808,2068,1784,1207,2117,1391,792,507,696,1193.0,909.0,11978,9866,1926,6467,6207,5271,10.0,3295.0,4039,59.0
Zip Code,2021,60634,77520,15738,10821,10920,11140,12006,8785,5645,2465,3661,5869.0,6201.0,73859,61782,11458,40219,37301,31680,4147.0,1919.0,38741,1033.0
Zip Code,2021,60636,30412,6796,4736,3468,3139,3953,3405,3498,1417,2017,2411.0,2368.0,28395,23616,6266,15764,14648,4273,49.0,25213.0,341,536.0
Zip Code,2021,60637,49514,11594,12076,5686,5685,5273,5224,2561,1415,2670,4530.0,4278.0,46844,37920,6060,27240,22274,1377,2503.0,36352.0,7374,1908.0
Zip Code,2021,60638,58959,14291,7806,9061,8027,8239,6491,2894,2150,3653,5613.0,5025.0,55306,44668,8057,28947,30012,32605,384.0,1583.0,23996,391.0
Zip Code,2021,60639,89037,23367,14895,13204,12078,9824,8980,4439,2250,5889,8890.0,8587.0,83148,65670,10528,45013,44024,66456,1772.0,11773.0,8026,1010.0
Zip Code,2021,60640,67936,8275,14058,14701,9720,9101,5610,3493,2978,3011,3162.0,2087.0,64925,59661,8976,32418,35518,9246,7216.0,11301.0,37673,2500.0
Zip Code,2021,60641,71003,16177,10483,12180,10340,9095,7209,3626,1893,4432,6361.0,5346.0,66571,54826,8030,36504,34499,38552,3487.0,1694.0,25142,2128.0
Zip Code,2021,60642,21374,1884,7010,6681,2697,1258,1258,399,187,996,503.0,385.0,20378,19490,1155,10672,10702,3406,1583.0,2021.0,13545,819.0
Zip Code,2021,60643,49796,11440,6035,5723,6039,7664,6678,3271,2946,2802,4116.0,4491.0,46994,38356,8986,26963,22833,1817,292.0,35528.0,10557,1602.0
Zip Code,2021,60644,47630,12279,7590,5998,6242,5407,5697,3011,1406,3357,5033.0,3887.0,44273,35351,6798,25600,22030,4335,303.0,40264.0,1811,917.0
Zip Code,2021,60645,48585,13057,7196,6388,6782,5537,5457,2663,1505,4211,4918.0,3918.0,44374,35528,6744,24038,24547,10050,7216.0,7263.0,21537,2519.0
Zip Code,2021,60646,29326,7002,3256,3810,4221,3711,3288,2280,1758,2014,2668.0,2320.0,27312,22324,5361,15857,13469,4113,3259.0,198.0,20895,861.0
Zip Code,2021,60647,85564,14620,20816,22494,10556,7690,5404,2522,1462,5488,5247.0,3860.0,80076,70944,6319,42804,42760,32028,3596.0,4961.0,42071,2908.0
Zip Code,2021,60649,48973,10532,7859,7993,5542,5755,6692,2991,1609,3375,4157.0,3000.0,45598,38441,7360,26516,22457,1409,294.0,45258.0,1394,618.0
Zip Code,2021,60651,64638,16307,11658,9381,8423,7136,6552,3379,1802,3826,6323.0,6152.0,60812,48331,8123,34297,30341,25519,161.0,34288.0,3583,1087.0
Zip Code,2021,60652,43485,11059,6951,5594,6664,5503,4559,2048,1107,2282,4342.0,4434.0,41203,32426,5265,22212,21273,20528,358.0,18340.0,3615,644.0
Zip Code,2021,60653,34519,8652,5294,4731,4096,4416,3959,2055,1316,2726,3055.0,2849.0,31793,25867,5161,20148,14371,1593,440.0,29390.0,2172,924.0
Zip Code,2021,60654,21859,926,7081,6891,2052,2412,1634,615,248,484,364.0,78.0,21375,20933,1672,10783,11076,1835,2671.0,898.0,15525,930.0
Zip Code,2021,60655,28751,7061,3795,3295,4013,4273,3559,1809,946,1619,2945.0,2497.0,27132,21690,4197,14472,14279,2691,411.0,1498.0,23305,846.0
Zip Code,2021,60656,28665,5489,3538,5182,3847,3713,3727,2030,1139,1865,2065.0,1559.0,26800,23176,5064,13832,14833,3647,3241.0,1034.0,20027,716.0
Zip Code,2021,60657,72113,9371,23860,17192,7404,5857,4513,2517,1399,4060,3341.0,1970.0,68053,62742,5948,34485,37628,6393,4688.0,2648.0,55384,3000.0
Zip Code,2021,60659,43729,11751,6546,6087,5544,5914,4722,1941,1224,3394,4027.0,4320.0,40335,31978,5117,22259,21470,10484,11678.0,3678.0,15716,2173.0
Zip Code,2021,60660,44972,5918,10937,9113,5752,4907,4343,2733,1269,2396,2288.0,1184.0,42576,39054,6121,22182,22790,7934,6118.0,6411.0,22391,2118.0
Zip Code,2021,60661,11073,870,3293,4199,1510,726,308,109,58,529,293.0,48.0,10544,10203,318,5369,5704,910,3177.0,262.0,6388,336.0
ZIP Code,2021,60666,0,0,0,0,0,0,0,0,0,0,0.0,0.0,0,0,0,0,0,0,0.0,0.0,0,0.0
Zip Code,2021,60707,41309,8672,5879,5966,5835,5481,4876,3055,1545,2030,3558.0,3084.0,39279,32637,6874,21941,19368,16839,1491.0,2796.0,19405,778.0
Zip Code,2021,60827,26010,8279,4338,3268,3208,2792,2673,1039,413,2374,3184.0,2714.0,23636,17731,2656,14285,11725,1764,3.0,23328.0,416,499.0
Zip Code,2021,60626,50295,8007,11937,8965,6995,6738,4360,2178,1115,2810,2977.0,2165.0,47485,42288,5098,25318,24977,9694,2724.0,12646.0,23029,2202.0
Zip Code,2021,60628,64489,13734,11638,7491,7593,9066,6930,4860,3177,3557,5498.0,4657.0,60932,50755,10940,34961,29528,2775,79.0,59168.0,1462,1005.0
Zip Code,2021,60629,107487,29283,20690,13227,14954,11096,8187,7688,2362,8267,10786.0,10229.0,99220,78204,13746,53753,53734,79111,595.0,18878.0,7650,1253.0
Zip Code,2021,60630,55591,11093,7053,8926,7337,7479,7975,3605,2123,3238,4359.0,3490.0,52353,44498,9658,27787,27804,14180,7122.0,1007.0,31325,1957.0
Zip Code,2021,60631,30589,6925,3308,4357,3813,4657,3686,1846,1997,2342,2663.0,1920.0,28247,23664,5546,15516,15073,4491,1262.0,307.0,23360,1169.0
